rrrrrrrrrrrrrrrrrrrrrrrrrrrrrr
b                 g          g
b                 g          g
b   P             g          g
b                 g          g
b                 g          g
b                 g          g
b     ggggggggggggg     #####g
b                 g          g
b  r              g          g
b                 g          g
b                            g
b                            g
b    gb           rrrrr    bbg
b                 r          g
b                 r          g
b                 r          g
b                 r          g
b###################  ########